©Àscripts	#scripts
©Àbehaviours	#behaviours
©Àbrains	#brains
©Àcameras	#cameras
©Àcomponents	#components
©Àlanguages	#languages
©Àmap	#map
©¦  ©Àlevels	#levels
©¦  ©Àrooms	#rooms
©¦  ©Àstatic_layouts	#static_layouts
©¦  ©Àrooms	#rooms
©¦  ©¦  ©Àhallway	#hallway
©¦  ©¦  ©Àhallway_armoury	#hallway_armoury
©¦  ©¦  ©Àhallway_residential	#hallway_residential
©¦  ©¦  ©Àhallway_residential_two	#hallway_residential_two
©¦  ©¦  ©Àroom	#room
©¦  ©¦  ©Àroom_armoury	#room_armoury
©¦  ©¦  ©Àroom_armoury_two	#room_armoury_two
©¦  ©¦  ©Àroom_open	#room_open
©¦  ©¦  ©Àroom_residential	#room_residential
©¦  ©¦  ©Àroom_residential_two	#room_residential_two
©¦  ©Àtasks	#tasks
©Ànis	#nis
©Àprefabs	#prefabs
©Àscenarios	#scenarios
©Àscreens	#screens
©Àstategraphs	#stategraphs
©Àwidgets	#widgets
