©Àsrc	#src
©À.idea	#.idea
©¦  ©Àcopyright	#copyright
©Àcocos	#cocos
©Àgamecore	#gamecore
©¦  ©Àcommon	#common
©¦  ©Àconfig	#config
©¦  ©¦  ©Àauto	#auto
©¦  ©¦  ©ÀsdkPay	#sdkPay
©¦  ©Àlog	#log
©¦  ©Àmanager	#manager
©Àmodules	#modules
©¦  ©Àachievement	#achievement
©¦  ©ÀactCode	#actCode
©¦  ©Àactivity	#activity
©¦  ©ÀactivityBox	#activityBox
©¦  ©ÀactivityPlay	#activityPlay
©¦  ©ÀaddGroupGifts	#addGroupGifts
©¦  ©Àanswer	#answer
©¦  ©Àbag	#bag
©¦  ©ÀbaiFu	#baiFu
©¦  ©ÀbindAccount	#bindAccount
©¦  ©ÀbloodSystem	#bloodSystem
©¦  ©Àboss	#boss
©¦  ©ÀbossFB	#bossFB
©¦  ©Àbuff	#buff
©¦  ©Àcaishen	#caishen
©¦  ©Àcelebration	#celebration
©¦  ©Àchat	#chat
©¦  ©ÀcheckIn	#checkIn
©¦  ©ÀchengZhan	#chengZhan
©¦  ©ÀcollectInfo	#collectInfo
©¦  ©Àcollege	#college
©¦  ©ÀconfigEvent	#configEvent
©¦  ©ÀcontactGM	#contactGM
©¦  ©ÀcrossServer	#crossServer
©¦  ©Àcs_FamilyBoss	#cs_FamilyBoss
©¦  ©ÀdaBaoNpc	#daBaoNpc
©¦  ©ÀdaBaoOutline	#daBaoOutline
©¦  ©ÀdailyRecharge	#dailyRecharge
©¦  ©ÀdaySpecial	#daySpecial
©¦  ©Àdeal	#deal
©¦  ©Àdepot	#depot
©¦  ©ÀdiamondGet	#diamondGet
©¦  ©Àdominate	#dominate
©¦  ©Àdungeon	#dungeon
©¦  ©ÀequipAdvance	#equipAdvance
©¦  ©Àexample	#example
©¦  ©ÀexchangeShop	#exchangeShop
©¦  ©Àfamily	#family
©¦  ©ÀfindBack	#findBack
©¦  ©ÀfindTreasure	#findTreasure
©¦  ©Àforge	#forge
©¦  ©ÀgameBox	#gameBox
©¦  ©Àgemstone	#gemstone
©¦  ©ÀgodEquips	#godEquips
©¦  ©ÀgodOfWar	#godOfWar
©¦  ©ÀgodStoneSys	#godStoneSys
©¦  ©ÀguaJiPractice	#guaJiPractice
©¦  ©ÀguidePs	#guidePs
©¦  ©ÀhallOfFame	#hallOfFame
©¦  ©ÀhangupPractice	#hangupPractice
©¦  ©Àhead	#head
©¦  ©ÀheFuHuoDong	#heFuHuoDong
©¦  ©Àhorcrux	#horcrux
©¦  ©ÀiosScore	#iosScore
©¦  ©ÀjieRi	#jieRi
©¦  ©ÀkfEscort	#kfEscort
©¦  ©Àkuafu	#kuafu
©¦  ©ÀlevelReward	#levelReward
©¦  ©Àlogin	#login
©¦  ©ÀmainUI	#mainUI
©¦  ©Àmap	#map
©¦  ©ÀmiJingShiLian	#miJingShiLian
©¦  ©Àmission	#mission
©¦  ©ÀnewerGuide	#newerGuide
©¦  ©ÀnewYearActivity	#newYearActivity
©¦  ©ÀnpcTalk	#npcTalk
©¦  ©ÀonlineLibao	#onlineLibao
©¦  ©ÀonlineReward	#onlineReward
©¦  ©ÀopenServerAct	#openServerAct
©¦  ©ÀopenServerGift	#openServerGift
©¦  ©Àranking	#ranking
©¦  ©Àrealm	#realm
©¦  ©ÀrebateActivity	#rebateActivity
©¦  ©Àrecharge	#recharge
©¦  ©ÀrechargePacks	#rechargePacks
©¦  ©Àremind	#remind
©¦  ©Àrole	#role
©¦  ©ÀscanQRCode	#scanQRCode
©¦  ©ÀsdkPlat	#sdkPlat
©¦  ©¦  ©Àqq	#qq
©¦  ©Àselectgit	#selectgit
©¦  ©Àsetting	#setting
©¦  ©ÀsevenDaysActivity	#sevenDaysActivity
©¦  ©Àshare	#share
©¦  ©Àshenqi	#shenqi
©¦  ©Àshop	#shop
©¦  ©ÀsilverFb	#silverFb
©¦  ©Àskill	#skill
©¦  ©Àsocial	#social
©¦  ©ÀspecialRing	#specialRing
©¦  ©Àstall	#stall
©¦  ©ÀsuperMember	#superMember
©¦  ©ÀsystemGlobal	#systemGlobal
©¦  ©ÀtdBossFB	#tdBossFB
©¦  ©Àtest	#test
©¦  ©¦  ©Àsystem	#system
©¦  ©ÀtestModule	#testModule
©¦  ©ÀtimerBuy	#timerBuy
©¦  ©Àtitle	#title
©¦  ©ÀtotalLogin	#totalLogin
©¦  ©ÀtotalRecharge	#totalRecharge
©¦  ©ÀtransferStone	#transferStone
©¦  ©ÀtransferSystem	#transferSystem
©¦  ©ÀupgradeActivity	#upgradeActivity
©¦  ©ÀupgradeDrug	#upgradeDrug
©¦  ©Àvip	#vip
©¦  ©Àvoice	#voice
©¦  ©Àwardrobe	#wardrobe
©¦  ©ÀwarOfCity	#warOfCity
©¦  ©ÀwuHun	#wuHun
©¦  ©Àxinfutehui	#xinfutehui
©¦  ©Àyoumingshendian	#youmingshendian
©¦  ©Àyueka	#yueka
©¦  ©Àplatform	#platform
©¦  ©¦  ©Àandroid	#android
©¦  ©¦  ©Àios	#ios
©¦  ©Àproto	#proto
©¦  ©Àscene	#scene
©¦  ©¦  ©Àelements	#elements
©¦  ©Àmap	#map
©¦  ©Àui	#ui
©¦  ©¦  ©Àrichlabel	#richlabel
©¦  ©¦  ©ÀScrollviewEtc	#ScrollviewEtc
©¦  ©¦  ©Àtestscene	#testscene
©¦  ©¦  ©ÀuiBaseClasses	#uiBaseClasses
©¦  ©Àutil	#util
©Àmodules	#modules
©¦  ©Àautotest	#autotest
©¦  ©¦  ©ÀtestBag	#testBag
©¦  ©Àcctest	#cctest
©¦  ©Àcmd	#cmd
©¦  ©Àtest	#test
